Date,Transactions,Balance
27/11/2023,1.0,1.0
28/11/2023,1.0,2.0
29/11/2023,1.0,3.0
30/11/2023,1.0,4.0
01/12/2023,1.0,5.0
02/12/2023,1.0,6.0
03/12/2023,1.0,7.0
04/12/2023,1.0,8.0
05/12/2023,1.0,9.0
06/12/2023,1.0,10.0
07/12/2023,1.0,11.0
08/12/2023,1.0,12.0
09/12/2023,1.0,13.0
10/12/2023,1.0,14.0
11/12/2023,1.0,15.0
12/12/2023,1.0,16.0
13/12/2023,1.0,17.0
14/12/2023,1.0,18.0
15/12/2023,1.0,19.0
16/12/2023,1.0,20.0
17/12/2023,1.0,21.0
18/12/2023,1.0,22.0
19/12/2023,1.0,23.0
20/12/2023,1.0,24.0
21/12/2023,1.0,25.0
22/12/2023,1.0,26.0
23/12/2023,1.0,27.0
24/12/2023,1.0,28.0
25/12/2023,1.0,29.0
26/12/2023,1.0,30.0
27/12/2023,1.0,31.0
28/12/2023,1.0,32.0
29/12/2023,1.0,33.0
30/12/2023,1.0,34.0
31/12/2023,1.0,35.0
01/01/2024,1.0,36.0
02/01/2024,1.0,37.0
03/01/2024,1.0,38.0
04/01/2024,1.0,39.0
05/01/2024,1.0,40.0
06/01/2024,1.0,41.0
27/11/2027,1.0,1.0
28/11/2027,1.0,2.0
29/11/2027,1.0,3.0
30/11/2027,1.0,4.0
01/12/2027,1.0,5.0
02/12/2027,1.0,6.0
03/12/2027,1.0,7.0
04/12/2027,1.0,8.0
05/12/2027,1.0,9.0
06/12/2027,1.0,10.0
07/12/2027,1.0,11.0
08/12/2027,1.0,12.0
09/12/2027,1.0,13.0
10/12/2027,1.0,14.0
11/12/2027,1.0,15.0
12/12/2027,1.0,16.0
13/12/2027,1.0,17.0
14/12/2027,1.0,18.0
15/12/2027,1.0,19.0
16/12/2027,1.0,20.0
17/12/2027,1.0,21.0
18/12/2027,1.0,22.0
19/12/2027,1.0,23.0
20/12/2027,1.0,24.0
21/12/2027,1.0,25.0
22/12/2027,1.0,26.0
23/12/2027,1.0,27.0
24/12/2027,1.0,28.0
25/12/2027,1.0,29.0
26/12/2027,1.0,30.0
27/12/2027,1.0,31.0
28/12/2027,1.0,32.0
29/12/2027,1.0,33.0
30/12/2027,1.0,34.0
31/12/2027,1.0,35.0
01/01/2028,1.0,36.0
02/01/2028,1.0,37.0
03/01/2028,1.0,38.0
04/01/2028,1.0,39.0
05/01/2028,1.0,40.0
06/01/2028,1.0,41.0
